21 21 21 21 21 21 21 21 21 21 21 21 21 21 21 21 21 21 21 21 21 21 21 21 21 21 21 21 21 21 21 21 21 21 21 21 21 21 21 21 21 21 21 21 21 21 21 21 21 21 
22 21 21 21 21 21 21 21 21 21 21 21 21 21 21 21 21 21 22 21 21 21 21 21 21 22 21 21 21 21 21 21 21 21 21 21 21 21 21 21 21 21 21 21 21 21 21 21 21 21 
21 21 21 22 21 21 31 29 29 29 29 29 29 29 32 21 21 21 21 21 21 21 21 21 21 21 21 21 21 21 21 21 21 21 21 21 21 21 22 21 21 21 21 21 21 22 21 21 21 22 
21 21 21 22 31 29 30 2 2 2 2 2 19 2 28 29 29 32 31 29 29 29 29 29 29 29 32 21 21 21 22 21 21 21 21 21 21 21 21 31 29 29 29 29 29 32 21 21 21 21 
21 21 21 21 27 2 19 19 2 3 2 2 19 19 2 2 2 28 30 2 2 2 2 2 2 2 28 29 29 32 21 21 21 21 21 21 31 29 29 30 2 19 2 2 19 28 32 21 21 21 
21 21 21 31 30 2 19 19 20 20 20 20 20 2 2 2 2 2 2 2 2 2 2 2 2 2 2 2 2 28 29 32 21 22 21 31 30 2 2 2 2 19 2 2 2 2 28 32 21 21 
21 21 31 30 2 2 2 2 20 1 1 1 20 2 2 19 2 2 2 2 2 2 3 2 2 2 2 2 2 2 2 28 29 29 29 30 2 2 2 20 20 20 20 20 20 20 2 26 21 21 
21 22 27 2 2 2 2 2 20 1 1 1 20 2 2 19 19 2 2 2 2 2 2 2 2 2 2 2 2 2 19 19 19 19 19 2 2 19 2 20 0 0 0 20 0 20 2 28 32 21 
21 21 27 2 3 2 3 2 20 1 1 1 20 2 2 2 2 19 2 2 2 2 2 2 3 2 2 2 2 19 19 19 19 19 19 19 19 19 3 20 0 0 0 20 0 20 2 19 26 21 
21 21 27 2 19 19 2 2 20 1 1 1 20 2 2 2 3 2 2 2 19 19 19 2 2 2 2 19 19 19 19 19 19 19 19 19 19 2 2 20 0 0 0 0 0 0 2 19 26 21 
21 21 27 2 19 3 2 2 20 1 1 1 20 2 2 2 2 2 2 19 19 19 19 2 2 2 2 19 19 19 19 19 19 19 19 19 19 2 2 20 0 0 0 20 0 20 2 2 26 21 
21 21 27 2 2 2 2 2 20 1 1 1 20 2 2 19 19 2 2 19 19 19 2 2 2 2 19 19 19 19 19 19 19 19 19 19 19 2 2 20 20 20 20 20 20 20 2 2 26 21 
21 21 33 25 2 2 14 12 20 20 1 20 20 12 15 19 19 3 2 2 19 19 2 2 2 2 19 19 19 19 19 19 19 2 2 2 19 19 2 2 2 2 2 2 2 2 2 2 26 21 
22 21 21 33 25 2 10 5 5 5 5 5 5 5 9 2 2 2 19 19 19 19 3 2 2 2 19 19 19 19 19 19 19 2 2 19 19 19 2 2 2 2 2 2 2 2 19 19 26 21 
21 21 21 21 27 2 10 5 5 5 5 5 5 5 11 12 12 12 12 15 2 2 2 2 2 2 2 2 19 19 19 19 19 19 2 19 19 19 19 2 2 2 2 2 19 19 19 19 26 22 
21 21 21 21 27 2 10 5 5 5 5 5 5 5 5 5 5 5 5 11 15 2 2 2 2 19 19 19 19 19 19 2 2 2 2 2 19 19 2 2 2 2 2 19 19 19 19 23 34 21 
21 21 21 22 30 2 16 7 7 7 7 7 7 7 7 7 7 8 5 5 9 2 2 2 2 19 19 19 19 19 2 2 2 2 2 2 2 2 2 19 19 2 3 19 19 23 24 34 21 21 
21 21 31 30 2 2 2 2 2 2 2 2 2 2 2 2 2 16 8 5 9 2 19 2 19 19 19 19 19 19 2 3 3 2 2 2 2 2 2 2 2 19 19 19 19 28 32 21 21 21 
21 21 27 2 2 2 2 2 2 2 2 2 2 2 2 2 2 2 10 5 9 2 2 2 2 19 19 19 19 19 19 2 2 2 19 19 19 19 19 2 2 3 19 19 19 19 26 21 21 21 
21 21 27 2 2 2 2 2 2 2 2 2 19 2 2 2 2 2 10 5 9 2 2 2 2 2 2 2 2 19 19 19 2 19 19 19 19 19 19 19 2 2 2 2 19 19 26 21 21 21 
22 21 27 2 2 2 2 2 2 2 19 19 19 19 19 2 2 2 10 5 9 20 20 20 20 20 20 20 2 19 19 19 2 19 19 19 19 19 19 19 2 2 2 2 2 2 26 21 21 21 
21 21 27 2 2 2 2 2 19 19 19 19 19 19 19 19 2 19 10 5 9 20 1 1 1 1 1 20 2 2 19 19 2 19 19 19 19 19 19 19 19 2 2 2 2 2 26 21 21 21 
21 21 27 2 2 2 3 2 19 19 19 19 19 19 19 19 2 2 10 5 9 20 1 1 1 1 1 20 2 2 19 19 2 2 19 19 19 19 19 19 19 19 2 2 2 2 26 21 21 21 
21 21 27 2 2 2 2 19 19 19 19 19 19 19 19 19 2 2 10 5 9 20 1 1 18 1 1 20 2 2 2 19 19 2 2 19 19 19 19 19 19 19 19 19 19 19 26 21 22 21 
21 22 33 25 2 2 2 19 19 19 19 19 19 2 2 2 2 2 10 5 9 20 1 1 1 1 1 20 2 2 2 19 19 19 2 2 19 19 19 19 19 19 19 19 19 19 26 21 21 21 
21 21 31 30 2 2 2 2 19 19 19 19 2 2 2 2 2 2 10 5 9 20 1 1 1 1 1 20 2 2 2 2 19 19 2 2 2 19 19 19 19 19 19 19 19 23 34 21 21 21 
22 21 27 2 2 2 2 2 2 19 19 19 2 2 2 2 2 2 10 5 9 20 1 1 1 1 1 20 2 2 3 2 19 19 19 2 2 2 19 19 19 19 2 2 23 34 21 21 21 21 
21 21 27 2 2 2 2 19 19 19 19 19 2 2 2 2 2 2 10 5 9 20 20 20 1 20 20 20 2 2 2 19 19 19 19 2 2 2 3 2 2 2 2 2 26 21 21 21 21 21 
21 21 27 2 2 2 2 2 19 19 19 19 2 2 2 2 2 19 10 5 9 2 2 10 5 9 2 2 2 2 2 2 19 19 19 2 2 2 2 2 2 2 2 2 26 21 22 21 21 21 
21 21 27 2 2 2 2 2 2 2 19 19 2 2 2 2 2 2 10 5 11 12 12 13 5 9 2 2 2 2 2 2 19 19 19 19 19 2 2 2 2 2 2 2 26 21 21 21 21 21 
21 21 27 2 2 2 2 19 19 19 19 19 2 2 2 2 2 3 10 5 5 5 5 5 5 9 2 19 2 2 2 19 19 19 19 19 2 2 2 2 2 2 2 2 28 29 32 21 21 21 
21 22 33 25 2 2 2 19 19 19 19 2 2 2 2 2 2 2 16 7 8 5 5 5 5 9 2 2 2 2 2 19 19 19 19 19 19 2 2 2 2 2 2 2 2 2 26 21 21 22 
21 21 21 27 2 2 2 2 19 19 19 2 19 19 19 2 2 2 2 2 16 7 7 8 5 9 2 2 3 2 2 2 19 19 19 19 19 2 2 3 2 2 2 2 2 2 26 21 21 21 
21 21 21 27 2 2 2 2 19 19 19 2 19 19 19 19 2 2 2 2 2 2 3 10 5 11 15 2 2 2 2 19 19 19 19 19 19 19 19 19 19 2 19 2 2 2 26 21 21 21 
21 21 21 27 2 2 2 2 2 2 2 2 2 19 19 19 19 19 2 2 2 2 2 10 5 5 11 15 2 2 2 19 19 19 19 19 19 19 19 19 19 19 19 2 2 19 26 21 21 21 
21 21 22 27 2 2 2 2 2 2 2 2 2 2 2 2 2 2 2 2 2 2 2 10 5 5 5 11 15 2 2 2 2 19 19 19 19 19 19 19 19 19 19 2 2 2 26 21 21 21 
21 21 21 27 2 2 2 2 2 3 2 2 2 19 2 2 2 2 2 19 2 19 2 10 5 5 5 5 11 15 2 2 2 2 19 19 19 19 19 19 19 19 2 19 2 2 26 22 21 21 
21 21 31 30 2 2 2 2 2 2 3 3 19 19 2 2 19 19 19 19 19 19 19 10 5 6 8 5 5 9 3 2 2 2 19 2 19 19 19 19 19 19 2 2 2 2 26 21 21 21 
21 21 27 2 2 2 2 2 2 2 19 19 19 19 19 19 19 19 19 19 2 2 19 10 5 9 16 7 7 17 2 2 19 2 2 3 2 2 2 2 2 2 2 2 3 19 26 21 21 21 
21 31 30 2 19 2 2 2 19 19 19 19 19 19 19 19 19 19 19 2 2 2 2 10 5 9 2 2 2 19 19 19 19 2 2 2 2 2 2 2 2 2 3 3 2 19 26 21 21 21 
31 30 2 2 3 2 19 19 19 19 19 19 19 2 19 19 19 19 2 19 2 2 2 10 5 9 2 19 19 19 19 19 19 2 2 2 2 2 2 2 2 2 3 2 19 2 26 21 21 21 
27 19 2 2 19 19 19 19 19 19 19 19 2 3 19 2 19 19 19 2 2 2 2 10 5 9 2 19 19 19 19 19 19 19 2 19 2 3 19 19 2 19 2 2 2 23 34 22 21 21 
27 2 19 19 19 19 19 19 19 19 19 2 2 2 2 2 2 3 2 2 19 2 2 2 7 17 2 2 19 19 19 19 2 2 19 19 19 19 19 2 19 2 19 19 2 26 21 21 21 21 
27 2 19 19 19 19 19 19 19 2 2 2 2 2 23 24 24 24 24 24 25 2 2 2 2 2 4 2 2 19 2 2 19 23 25 2 19 2 2 2 19 2 2 19 2 28 32 21 21 21 
27 2 3 19 19 19 2 2 2 2 2 2 2 23 34 21 21 21 21 21 33 24 24 25 2 2 2 2 3 2 23 24 24 34 33 25 19 19 2 19 2 20 20 20 20 2 26 21 21 21 
33 25 2 2 2 3 2 19 2 2 2 2 23 34 21 21 21 21 21 21 21 21 21 33 24 24 24 24 24 24 34 21 21 21 22 33 25 2 19 2 2 20 0 0 20 19 26 21 21 21 
21 27 2 2 2 2 2 2 23 24 24 24 34 21 21 21 21 21 21 21 22 21 21 21 21 21 21 21 21 21 21 21 21 21 21 21 33 25 2 2 2 20 0 0 20 2 26 21 21 21 
21 33 24 24 24 24 24 24 34 21 21 21 21 21 21 21 21 21 21 21 21 21 21 21 21 22 21 21 21 21 21 21 21 21 21 21 21 33 24 25 2 20 20 20 20 2 26 21 21 21 
22 21 21 21 21 21 21 21 21 21 21 22 21 21 21 21 21 21 21 21 21 21 21 21 21 21 21 21 22 21 21 21 21 21 21 22 21 21 21 33 25 2 2 2 19 23 34 21 21 21 
21 21 21 21 21 21 22 21 21 21 21 21 21 21 21 21 22 21 21 21 21 21 21 21 21 21 21 21 21 21 21 21 21 21 21 21 21 21 21 21 33 24 24 24 24 34 21 21 21 21 
